2 2 2 2 2 2 2 2 2 2 2 2 2 2 2 2 2 2 2 2 2 2 2 2 2 2 2 2 2 2 2 2 2 2 2 2 2 2 2 2 2 2 2 2 2 2 2 2 2 2
2 4 4 4 4 4 4 4 4 4 4 4 4 4 4 4 4 4 4 4 4 4 4 4 4 4 4 4 4 4 4 4 4 4 4 4 4 4 4 4 4 4 4 4 4 4 4 4 4 2
2 4 4 4 4 4 4 4 4 4 4 4 4 4 4 4 4 4 4 4 4 4 4 4 4 4 4 4 4 4 4 4 4 4 4 4 4 4 4 4 4 4 4 4 4 4 4 4 4 2
2 4 4 4 4 4 4 4 4 4 4 4 4 4 4 4 4 4 4 4 4 4 4 4 4 4 4 4 4 4 4 4 4 4 4 4 4 4 4 4 4 4 4 4 4 4 4 4 4 2
2 4 4 4 4 4 4 4 4 4 4 4 4 4 4 4 4 4 4 4 4 4 4 4 4 4 4 4 4 4 4 4 4 4 4 4 4 4 4 4 4 4 4 4 4 4 4 4 4 2
2 4 4 4 4 2 2 2 2 2 2 2 2 2 2 2 2 2 2 2 2 2 2 2 2 2 2 2 2 2 2 2 2 2 2 2 2 2 2 2 2 2 2 2 2 4 4 4 4 2
2 4 4 4 4 2 3 3 3 3 3 3 3 3 3 3 3 3 3 3 3 3 3 3 3 3 3 3 3 3 3 3 3 3 3 3 3 3 3 3 3 3 3 3 2 4 4 4 4 2
2 4 4 4 4 2 3 5 5 5 5 5 5 5 5 5 5 5 5 5 5 5 5 5 5 5 5 5 5 5 5 5 5 5 5 5 5 5 5 5 5 5 5 3 2 4 4 4 4 2
2 4 4 4 4 2 3 5 6 6 6 5 5 5 6 6 6 5 5 5 6 6 6 5 5 5 6 6 6 5 5 5 6 6 6 5 5 5 6 6 6 6 5 3 2 4 4 4 4 2
2 4 4 4 4 2 3 5 6 5 5 5 5 5 5 5 5 5 5 5 5 5 5 5 5 5 5 5 5 5 5 5 5 5 5 5 5 5 5 5 5 6 5 3 2 4 4 4 4 2
2 4 4 4 4 2 3 5 6 5 3 3 3 3 3 3 3 3 3 3 3 3 3 5 6 5 3 3 3 3 3 3 3 3 3 3 3 3 3 3 5 6 5 3 2 4 4 4 4 2
2 4 4 4 4 2 3 5 5 5 3 0 0 0 0 0 0 0 0 0 0 0 3 5 6 5 3 0 0 0 0 0 0 0 0 0 0 0 0 3 5 6 5 3 2 4 4 4 4 2
2 4 4 4 4 2 3 5 5 5 3 0 0 0 0 0 0 0 0 0 0 0 3 5 6 5 3 0 0 0 0 0 0 0 0 0 0 0 0 3 5 6 5 3 2 4 4 4 4 2
2 4 4 4 4 2 3 5 5 5 3 0 0 0 0 0 0 0 0 0 0 0 3 5 5 5 3 0 0 0 0 0 0 0 0 0 0 0 0 3 5 6 5 3 2 4 4 4 4 2
2 4 4 4 4 2 3 5 6 5 3 0 0 0 0 0 0 0 0 0 0 0 3 5 5 5 3 0 0 0 0 0 0 0 0 0 0 0 0 3 5 6 5 3 2 4 4 4 4 2
2 4 4 4 4 2 3 5 6 5 3 0 0 0 0 0 0 0 0 0 0 0 3 5 5 5 3 0 0 0 0 0 0 0 0 0 0 0 0 3 5 6 5 3 2 4 4 4 4 2
2 4 4 4 4 2 3 5 6 5 3 0 0 0 0 0 0 0 0 0 0 0 3 5 6 5 3 0 0 0 0 0 0 0 0 0 0 0 0 3 5 6 5 3 2 4 4 4 4 2
2 4 4 4 4 2 3 5 5 5 3 0 0 0 0 0 0 0 0 0 0 0 3 5 6 5 3 0 0 0 0 0 0 0 0 0 0 0 0 3 5 6 5 3 2 4 4 4 4 2
2 4 4 4 4 2 3 5 5 5 3 0 0 0 0 0 0 0 0 0 0 0 3 5 6 5 3 0 0 0 0 0 0 0 0 0 0 0 0 3 5 6 5 3 2 4 4 4 4 2
2 4 4 4 4 2 3 5 5 5 3 0 0 0 0 0 0 0 0 0 0 0 3 5 5 5 3 0 0 0 0 0 0 0 0 0 0 0 0 3 5 6 5 3 2 4 4 4 4 2
2 4 4 4 4 2 3 5 6 5 3 0 0 0 0 0 0 0 0 0 0 0 3 5 5 5 3 0 0 0 0 0 0 0 0 0 0 0 0 3 5 6 5 3 2 4 4 4 4 2
2 4 4 4 4 2 3 5 6 5 3 0 0 0 0 0 0 0 0 0 0 0 3 5 5 5 3 0 0 0 0 0 0 0 0 0 0 0 0 3 5 6 5 3 2 4 4 4 4 2
2 4 4 4 4 2 3 5 6 5 3 3 3 3 3 3 3 3 3 3 3 3 3 5 6 5 3 3 3 3 3 3 3 3 3 3 3 3 3 3 5 6 5 3 2 4 4 4 4 2
2 4 4 4 4 2 3 5 5 5 5 5 5 5 5 5 5 5 5 5 5 5 5 5 6 5 5 5 5 5 5 5 5 5 5 5 5 5 5 5 5 5 5 3 2 4 4 4 4 2
2 4 4 4 4 2 3 5 5 5 6 6 6 5 5 5 6 6 6 5 5 5 6 6 6 6 6 5 5 5 6 6 6 5 5 5 6 6 6 5 5 5 5 3 2 4 4 4 4 2
2 4 4 4 4 2 3 5 5 5 5 5 5 5 5 5 5 5 5 5 5 5 5 5 6 5 5 5 5 5 5 5 5 5 5 5 5 5 5 5 5 5 5 3 2 4 4 4 4 2
2 4 4 4 4 2 3 5 6 5 3 3 3 3 3 3 3 3 3 3 3 3 3 5 6 5 3 3 3 3 3 3 3 3 3 3 3 3 3 3 5 6 5 3 2 4 4 4 4 2
2 4 4 4 4 2 3 5 6 5 3 0 0 0 0 0 0 0 0 0 0 0 3 5 5 5 3 0 0 0 0 0 0 0 0 0 0 0 0 3 5 6 5 3 2 4 4 4 4 2
2 4 4 4 4 2 3 5 6 5 3 0 0 0 0 0 0 0 0 0 0 0 3 5 5 5 3 0 0 0 0 0 0 0 0 0 0 0 0 3 5 6 5 3 2 4 4 4 4 2
2 4 4 4 4 2 3 5 5 5 3 0 0 0 0 0 0 0 0 0 0 0 3 5 5 5 3 0 0 0 0 0 0 0 0 0 0 0 0 3 5 6 5 3 2 4 4 4 4 2
2 4 4 4 4 2 3 5 5 5 3 0 0 0 0 0 0 0 0 0 0 0 3 5 6 5 3 0 0 0 0 0 0 0 0 0 0 0 0 3 5 6 5 3 2 4 4 4 4 2
2 4 4 4 4 2 3 5 5 5 3 0 0 0 0 0 0 0 0 0 0 0 3 5 6 5 3 0 0 0 0 0 0 0 0 0 0 0 0 3 5 6 5 3 2 4 4 4 4 2
2 4 4 4 4 2 3 5 6 5 3 0 0 0 0 0 0 0 0 0 0 0 3 5 6 5 3 0 0 0 0 0 0 0 0 0 0 0 0 3 5 6 5 3 2 4 4 4 4 2
2 4 4 4 4 2 3 5 6 5 3 0 0 0 0 0 0 0 0 0 0 0 3 5 5 5 3 0 0 0 0 0 0 0 0 0 0 0 0 3 5 6 5 3 2 4 4 4 4 2
2 4 4 4 4 2 3 5 6 5 3 0 0 0 0 0 0 0 0 0 0 0 3 5 5 5 3 0 0 0 0 0 0 0 0 0 0 0 0 3 5 6 5 3 2 4 4 4 4 2
2 4 4 4 4 2 3 5 5 5 3 0 0 0 0 0 0 0 0 0 0 0 3 5 5 5 3 0 0 0 0 0 0 0 0 0 0 0 0 3 5 6 5 3 2 4 4 4 4 2
2 4 4 4 4 2 3 5 5 5 3 0 0 0 0 0 0 0 0 0 0 0 3 5 6 5 3 0 0 0 0 0 0 0 0 0 0 0 0 3 5 6 5 3 2 4 4 4 4 2
2 4 4 4 4 2 3 5 5 5 3 0 0 0 0 0 0 0 0 0 0 0 3 5 6 5 3 0 0 0 0 0 0 0 0 0 0 0 0 3 5 6 5 3 2 4 4 4 4 2
2 4 4 4 4 2 3 5 6 5 3 3 3 3 3 3 3 3 3 3 3 3 3 5 6 5 3 3 3 3 3 3 3 3 3 3 3 3 3 3 5 6 5 3 2 4 4 4 4 2
2 4 4 4 4 2 3 5 6 5 5 5 5 5 5 5 5 5 5 5 5 5 5 5 5 5 5 5 5 5 5 5 5 5 5 5 5 5 5 5 5 6 5 3 2 4 4 4 4 2
2 4 4 4 4 2 3 5 6 6 6 5 5 5 6 6 6 5 5 5 6 6 6 5 5 5 6 6 6 5 5 5 6 6 6 5 5 5 6 6 6 6 5 3 2 4 4 4 4 2
2 4 4 4 4 2 3 5 5 5 5 5 5 5 5 5 5 5 5 5 5 5 5 5 5 5 5 5 5 5 5 5 5 5 5 5 5 5 5 5 5 5 5 3 2 4 4 4 4 2
2 4 4 4 4 2 3 3 3 3 3 3 3 3 3 3 3 3 3 3 3 3 3 3 3 3 3 3 3 3 3 3 3 3 3 3 3 3 3 3 3 3 3 3 2 4 4 4 4 2
2 4 4 4 4 2 2 2 2 2 2 2 2 2 2 2 2 2 2 2 2 2 2 2 2 2 2 2 2 2 2 2 2 2 2 2 2 2 2 2 2 2 2 2 2 4 4 4 4 2
2 4 4 4 4 4 4 4 4 4 4 4 4 4 4 4 4 4 4 4 4 4 4 4 4 4 4 4 4 4 4 4 4 4 4 4 4 4 4 4 4 4 4 4 4 4 4 4 4 2
2 4 4 4 4 4 4 4 4 4 4 4 4 4 4 4 4 4 4 4 4 4 4 4 4 4 4 4 4 4 4 4 4 4 4 4 4 4 4 4 4 4 4 4 4 4 4 4 4 2
2 4 4 4 4 4 4 4 4 4 4 4 4 4 4 4 4 4 4 4 4 4 4 4 4 4 4 4 4 4 4 4 4 4 4 4 4 4 4 4 4 4 4 4 4 4 4 4 4 2
2 4 4 4 4 4 4 4 4 4 4 4 4 4 4 4 4 4 4 4 4 4 4 4 4 4 4 4 4 4 4 4 4 4 4 4 4 4 4 4 4 4 4 4 4 4 4 4 4 2
2 2 2 2 2 2 2 2 2 2 2 2 2 2 2 2 2 2 2 2 2 2 2 2 2 2 2 2 2 2 2 2 2 2 2 2 2 2 2 2 2 2 2 2 2 2 2 2 2 2